# The index of map starts with 0

# 0 is black, 1 is white.

# The common size of game map is 12.

# In 'S x y':
# x is the width, and y is height.

# Samples:
#
# S 0 5             # S = start
# D 11 5 0          # D = destination, the 3rd number is the direction, 0 is DOWN, 90 is RIGHT, 180 is UP, 270 is LEFT.
# T 3 11 0          # T = trap, if the direction is 180, it means the trap is like 'VVV'.
# A 11 11 180       # A = arrow.
# K 0 6 0 1 2 3     # K = key, the 3rd and more number is id of blocks.
# B 8 11 1 0 0      # B = block, the 1st & 2nd number is start location, the 3rd is length, the 4th is direction, the 5th is id.
# L 6 5 0 1 2 3 4   # L = lamp, the 3rd and more number is id of mosaics.
# M 6 6 0           # M = mosaic, the 3rd number is id.

begin # 1 (how to run)

12

1 1 1 1 1 1 1 1 1 1 1 1
1 1 1 1 1 1 1 1 1 1 1 1
1 1 1 1 1 1 1 1 1 1 1 1
1 1 1 1 1 1 1 1 1 1 1 1
1 1 1 1 1 1 1 1 1 1 1 1
1 1 1 1 1 1 1 1 1 1 1 1
0 0 0 0 0 0 0 0 0 0 0 0
0 0 0 0 0 0 0 0 0 0 0 0
0 0 0 0 0 0 0 0 0 0 0 0
0 0 0 0 0 0 0 0 0 0 0 0
0 0 0 0 0 0 0 0 0 0 0 0
0 0 0 0 0 0 0 0 0 0 0 0

S 0 5
D 11 5 0

end

begin # 2 (how to jump)

12

1 1 1 1 1 1 1 1 1 1 1 1
1 1 1 1 1 1 1 1 1 1 1 1
1 1 1 1 1 1 1 1 1 1 1 1
1 1 1 1 1 1 1 1 1 1 1 1
1 1 1 1 1 1 1 1 1 1 1 1
1 1 1 1 1 1 1 1 1 1 1 1
0 0 0 1 1 0 0 0 1 1 0 0
0 0 0 1 1 0 0 0 1 1 0 0
0 0 0 1 1 0 0 0 1 1 0 0
0 0 0 1 1 0 0 0 1 1 0 0
0 0 0 1 1 0 0 0 1 1 0 0
0 0 0 1 1 0 0 0 1 1 0 0

S 0 5
D 11 5 0
T 3 11 0
T 4 11 0
T 8 11 0
T 9 11 0

end

begin # 3 (how to shift)

12

1 1 1 1 1 0 0 1 1 1 1 1
1 1 1 1 1 0 0 1 1 1 1 1
1 1 1 1 1 0 0 1 1 1 1 1
1 1 1 1 1 0 0 1 1 1 1 1
1 1 1 1 1 0 0 1 1 1 1 1
1 1 1 1 1 0 0 1 1 1 1 1
1 1 1 1 1 0 0 1 1 1 1 1
0 0 0 0 0 0 0 0 0 0 0 0
0 0 0 0 0 0 0 0 0 0 0 0
0 0 0 0 0 0 0 0 0 0 0 0
0 0 0 0 0 0 0 0 0 0 0 0
0 0 0 0 0 0 0 0 0 0 0 0

S 0 6
D 11 6 0
T 5 0 180
T 6 0 180

end

begin # 4 (key & block)

12

1 1 1 1 1 1 1 1 1 1 1 1
1 1 1 1 1 1 1 1 1 1 1 1
1 1 1 1 1 1 1 1 1 1 1 1
1 1 1 1 1 1 1 1 1 1 1 1
1 1 1 1 1 1 1 1 1 1 1 1
1 1 1 1 1 1 1 1 1 1 1 1
1 1 1 1 1 1 1 1 1 1 1 1
0 0 0 0 0 0 1 0 0 1 1 1
1 1 1 1 0 1 1 1 1 1 1 1
1 1 1 1 1 1 1 1 1 1 1 1
1 1 1 1 1 1 1 1 1 1 1 1
1 1 1 1 1 1 1 1 1 1 1 1

S 0 11
D 11 11 0
K 0 6 4
K 4 6 0 1 2 3
K 2 10 4
B 8 11 1 0 0
B 9 10 2 0 1
B 10 9 3 0 2
B 11 8 4 0 3
B 4 9 3 0 4

end

begin # 5 (arrow)

12

0 0 1 1 1 1 1 1 1 1 1 1
0 0 1 1 1 1 1 1 1 1 1 1
0 1 1 1 1 1 1 1 0 0 0 0
0 1 1 1 1 1 1 1 1 1 1 1
0 0 0 0 0 1 1 0 1 1 1 1
0 0 0 0 1 1 1 0 0 0 1 1
0 0 0 0 1 1 1 1 1 1 1 0
1 1 1 1 1 1 0 0 0 0 0 0
1 1 1 1 0 1 1 1 1 1 1 1
0 0 0 0 0 0 0 0 0 0 0 0
0 0 0 0 0 0 0 0 0 0 0 0
1 1 1 1 1 1 1 1 1 1 1 1

S 0 11
D 11 1 90

T 11 0 90
A 11 11 180
A 0 9 180
A 1 0 90
A 2 0 90

end

begin # 6 (lamp & mosaic)

12

1 1 1 1 1 1 1 1 1 1 1 1
1 1 1 1 1 1 1 1 1 1 1 1
1 1 1 1 1 1 1 1 1 1 1 1
1 1 1 1 1 1 1 1 1 1 1 1
1 1 1 0 0 0 0 0 1 1 1 1
1 1 1 0 0 0 0 0 1 1 1 1
1 1 1 0 0 1 0 0 1 1 1 1
0 1 1 0 1 1 1 0 1 1 1 1
0 0 0 0 0 0 0 0 0 0 0 1
0 0 0 0 0 0 0 0 0 0 0 0
0 0 0 0 0 0 0 0 0 0 0 0
0 0 0 0 0 0 0 0 0 0 0 0

S 9 7
D 11 8 0

T 3 4 180
T 4 4 180
T 5 4 180
T 6 4 180
T 7 4 180

M 2 8 0
M 3 8 1
M 4 8 2
M 5 8 3
M 6 8 4
M 7 8 5
M 8 8 6

L 1 5 0 1 2 3 4 5 6

M 10 7 7
M 11 7 8
M 10 8 9
M 10 9 10
M 11 9 11

L 5 6 7 8 9 10 11

end

begin

12

1 1 1 1 1 1 1 1 1 1 1 1
1 1 1 1 1 1 1 1 1 1 1 1
1 1 1 1 1 1 1 1 1 1 1 1
1 1 1 1 1 1 1 1 1 1 1 1
1 1 1 1 1 1 1 1 1 1 1 1
1 1 0 1 0 1 0 1 1 1 1 1
0 0 0 0 0 0 0 0 0 0 0 0
0 0 0 0 0 0 0 0 0 0 0 0
0 0 0 0 0 0 0 0 0 0 0 0
0 0 0 0 0 0 0 0 0 0 0 0
0 0 0 0 0 0 0 0 0 0 0 0
0 0 0 0 0 0 0 0 0 0 0 0

S 0 5
D 11 5 0
# T 0 3 180
T 1 3 180
T 2 3 180
T 3 3 180
T 4 3 180
T 5 3 180
T 6 3 180
T 7 3 180
T 8 3 180

end

begin

12

1 0 1 0 0 0 0 0 0 0 0 0
0 1 1 1 0 1 0 0 0 0 0 0
0 0 1 0 1 1 1 0 1 0 0 0
0 1 0 0 0 1 0 1 1 1 0 0
1 1 1 0 1 0 0 0 1 0 0 0
0 1 0 1 1 1 0 1 0 0 0 0
0 0 0 0 1 0 1 1 1 0 1 0
0 0 0 1 0 0 0 1 0 1 1 1
0 0 1 1 1 0 1 0 0 0 1 0
0 0 0 1 0 1 1 1 0 1 0 0
0 0 0 0 0 0 1 0 1 1 1 0
0 0 0 0 0 0 0 0 0 1 0 1

S 0 0
D 9 11 0

A 3 0 0
A 1 4 0
A 11 9 0
A 8 11 180

end
