# This file must end with a new line!

# The index starts with 0

# 0 is black, 1 is white.

# The common size of game map is 12.

# In 'S x y':
# x is the width, and y is height.

6

begin

12

1 1 1 1 1 1 1 1 1 1 1 1
1 1 1 1 1 1 1 1 1 1 1 1
1 1 1 1 1 1 1 1 1 1 1 1
1 1 1 1 1 1 1 1 1 1 1 1
1 1 1 1 1 1 1 1 1 1 1 1
1 1 1 1 1 1 1 1 1 1 1 1
0 0 0 0 0 0 0 0 0 0 0 0
0 0 0 0 0 0 0 0 0 0 0 0
0 0 0 0 0 0 0 0 0 0 0 0
0 0 0 0 0 0 0 0 0 0 0 0
0 0 0 0 0 0 0 0 0 0 0 0
0 0 0 0 0 0 0 0 0 0 0 0

S 0 5
D 11 5 0

end

begin

12

1 1 1 1 1 1 1 1 1 1 1 1
1 1 1 1 1 1 1 1 1 1 1 1
1 1 1 1 1 1 1 1 1 1 1 1
1 1 1 1 1 1 1 1 1 1 1 1
1 1 1 1 1 1 1 1 1 1 1 1
1 1 1 1 1 1 1 1 1 1 1 1
0 0 0 1 1 0 0 0 1 1 0 0
0 0 0 1 1 0 0 0 1 1 0 0
0 0 0 1 1 0 0 0 1 1 0 0
0 0 0 1 1 0 0 0 1 1 0 0
0 0 0 1 1 0 0 0 1 1 0 0
0 0 0 1 1 0 0 0 1 1 0 0

S 0 5
D 11 5 0
T 3 11 0
T 4 11 0
T 8 11 0
T 9 11 0

end

begin

12

1 1 1 1 1 1 1 1 1 1 1 1
1 1 1 1 1 1 1 1 1 1 1 1
1 1 1 1 1 1 1 1 1 1 1 1
1 1 1 1 1 1 1 1 1 1 1 1
1 1 1 1 1 1 1 1 1 1 1 1
1 1 1 1 1 1 0 0 0 0 0 0
1 1 1 1 1 1 0 0 0 0 0 0
0 0 0 0 0 0 0 0 0 0 0 0
0 0 0 0 0 0 0 0 0 0 0 0
0 0 0 0 0 0 0 0 0 0 0 0
0 0 0 0 0 0 0 0 0 0 0 0
0 0 0 0 0 0 0 0 0 0 0 0

S 0 6
D 11 4 0

end

begin

12

0 0 1 1 1 1 1 1 1 1 1 1
0 0 1 1 1 1 1 1 1 1 1 1
0 1 1 1 1 1 1 1 0 0 0 0
0 1 1 1 1 1 1 1 1 1 1 1
0 0 0 0 0 1 1 0 1 1 1 1
0 0 0 0 1 1 1 0 0 0 1 1
0 0 0 0 1 1 1 1 1 1 1 0
1 1 1 1 1 1 0 0 0 0 0 0
1 1 1 1 0 1 1 1 1 1 1 1
0 0 0 0 0 0 0 0 0 0 0 0
0 0 0 0 0 0 0 0 0 0 0 0
1 1 1 1 1 1 1 1 1 1 1 1

S 0 11
D 11 1 90
A 11 11 180
A 0 9 180
A 1 0 90
A 2 0 90

end

begin

12

1 0 1 0 0 0 0 0 0 0 0 0
0 1 1 1 0 1 0 0 0 0 0 0
0 0 1 0 1 1 1 0 1 0 0 0
0 1 0 0 0 1 0 1 1 1 0 0
1 1 1 0 1 0 0 0 1 0 0 0
0 1 0 1 1 1 0 1 0 0 0 0
0 0 0 0 1 0 1 1 1 0 1 0
0 0 0 1 0 0 0 1 0 1 1 1
0 0 1 1 1 0 1 0 0 0 1 0
0 0 0 1 0 1 1 1 0 1 0 0
0 0 0 0 0 0 1 0 1 1 1 0
0 0 0 0 0 0 0 0 0 1 0 1

S 0 0
D 9 11 0

A 3 0 0
A 1 4 0
A 11 9 0
A 8 11 180

end

begin

12

1 1 1 1 1 1 1 1 1 1 1 1
1 1 1 1 1 1 1 1 1 1 1 1
1 1 1 1 1 1 1 1 1 1 1 1
1 1 1 1 1 1 1 1 1 1 1 1
1 1 1 1 1 1 1 1 1 1 1 1
1 1 1 1 1 1 1 1 1 1 1 1
0 0 0 0 0 0 0 0 0 0 0 0
0 0 0 0 0 0 0 0 0 0 0 0
0 0 0 0 0 0 0 0 0 0 0 0
0 0 0 0 0 0 0 0 0 0 0 0
0 0 0 0 0 0 0 0 0 0 0 0
0 0 0 0 0 0 0 0 0 0 0 0

S 0 5
D 11 5 0

end